,UPN,Delete messages from Deleted Items folder,Failed log on,Suspicious Email,UPN Count,Threat Count,AvgProbability
0,abhinaya.sathyanarayanan,4,0,0,4,4,0.7168
1,ajeesh.mohamed,2,0,0,2,2,0.7206
2,ajeethkumar.thangaraj,2,0,0,2,2,0.7528
3,amit.dixit,12,1,0,13,13,0.8697
4,amjathkumar.murugan,1,0,0,1,1,0.8396
5,anand.lakshmanan,1,0,0,1,1,0.7451
6,anandraj.chinnathambi,1,0,0,1,1,0.8063
7,ananthi.karuppusamy,1,0,0,1,1,0.8632
8,ankit.kumar,0,1,0,1,1,0.7816
9,ankit.kumar,0,1,0,1,1,0.8259
10,antonyja,0,1,0,1,1,0.8359
11,aravindhan.amaranathan,1,0,0,1,1,0.764
12,aravindhasamy.balasubramaniyam,4,0,0,4,4,0.8173
13,arun.kumarasamy,2,0,0,2,2,0.8052
14,arunkumar.palanisamy,1,1,0,2,2,0.7203
15,arunkumar.venugopal,1,0,0,1,1,0.7974
16,arunpranesh.maria,1,0,0,1,1,0.7856
17,arunprasad.kanagaraj,3,1,0,4,4,0.7465
18,ashok.balaraman,3,0,0,3,3,0.8097
19,ashwin.balan,4,2,0,6,6,0.748
20,avadhut.patil,0,1,0,1,1,0.7486
21,avadhut.patil,0,1,0,1,1,0.8305
22,balaji.krishnamoorthy,2,0,0,2,2,0.8686
23,balajiv,1,0,0,1,1,0.7758
24,balakumar.palanisamy,2,0,0,2,2,0.7548
25,balasubramanian.duraisamy,4,1,0,5,5,0.8242
26,boopathyraj.venkatachalam,3,2,0,5,5,0.8297
27,boovarahan.alagar,1,0,0,1,1,0.8212
28,chandramohan.subramaniam,2,0,0,2,2,0.7378
29,chandrasekar.moorthy,1,0,0,1,1,0.8318
30,chithiraiselvi.rajan,3,0,0,3,3,0.7371
31,crisin.john,1,0,0,1,1,0.8216
32,customerreceivables-finance,2,0,0,2,2,0.717
33,deebika.subramani,1,0,0,1,1,0.7846
34,deepakdhoundiyal,5,1,0,6,6,0.8732
35,dhandapani.perumal,1,0,0,1,1,0.8146
36,dineshkumar.thangaraj,2,0,0,2,2,0.831
37,divya.mehta,6,1,0,7,7,0.8343
38,divya.ramachandran,1,0,0,1,1,0.7929
39,eswaramoorthi.palanisamy,0,1,0,1,1,0.8469
40,falmeida,4,2,0,6,6,0.7969
41,ganesh.manickam,15,0,0,15,15,0.842
42,ganeshkumar.subbaiyan,1,0,0,1,1,0.7277
43,gopalswamy.nachimuthu,5,0,0,5,5,0.8221
44,gopi.mannar,2,2,0,4,4,0.8092
45,gunjan.singh,3,0,0,3,3,0.8664
46,hanmant.bhise,8,0,0,8,8,0.8689
47,hargovind.sharma,1,0,0,1,1,0.7798
48,hariharan.thiyagarajan,1,0,0,1,1,0.8404
49,harish.indaran,1,0,0,1,1,0.8296
50,hemant.singh,0,1,0,1,1,0.7699
51,imrankhan.noormohamed,1,0,0,1,1,0.7955
52,iraahuja,3,1,0,4,4,0.8579
53,itsupport.plant9,1,0,0,1,1,
54,jagat.singh,1,0,0,1,1,0.7111
55,jayaramp,1,4,0,5,5,0.7404
56,jos,2,0,0,2,2,0.8259
57,kanagaraj.govindasamy,31,1,0,32,32,0.8505
58,karchiappan.natarajan,1,0,0,1,1,0.7199
59,karthik.chinnasamy,2,0,0,2,2,0.862
60,karthik.karuppusamy,2,0,0,2,2,0.7246
61,karthik.ramadoss,1,0,0,1,1,0.712
62,karthik.sudevan,1,0,0,1,1,0.8462
63,karthik.sudevan,1,0,0,1,1,0.752
64,karthikeyan.selvaraj,1,0,0,1,1,0.7513
65,karthikeyan.sivakumar,2,0,0,2,2,0.8479
66,kumaralingamv,2,2,0,4,4,0.7873
67,kumuthavalli.loganathan,1,0,0,1,1,0.7212
68,lalit.joshi,5,1,0,6,6,0.7132
69,latha.marudhachalam,1,0,0,1,1,0.8495
70,luis.gasparini,1,0,0,1,1,0.7323
71,madhavaraj.guru,1,0,0,1,1,0.8496
72,madhu.ramsingh,1,0,0,1,1,0.7476
73,mahendran.krishnasamy,0,1,0,1,1,0.7522
74,mandeep.saxena,2,1,0,3,3,0.8557
75,manikandan.jagatheesan,0,1,0,1,1,0.7254
76,manishankar.baskaran,1,1,0,2,2,0.8097
77,mansoorahamed.musthafa,0,1,1,2,2,0.8168
78,megala.muthusamy,1,0,0,1,1,0.8111
79,mohammedali.yakubali,0,1,0,1,1,0.8191
80,mohan.karuppanasamy,2,0,0,2,2,0.8413
81,mohan.sivaraj,1,1,0,2,2,0.7499
82,mohsin.lalkhan,0,1,0,1,1,0.7707
83,munichamy.gurusamy,1,0,0,1,1,0.8262
84,muralidaran.m,0,1,0,1,1,0.7637
85,muralitharan.athikesavan,1,0,0,1,1,0.8455
86,murugesan.velayutham,1,1,0,2,2,0.8475
87,muthukumar.vellingiri,1,0,0,1,1,0.8062
88,muthukumar.vellingiri,1,0,0,1,1,0.8175
89,mythili.chandrasekaran,5,1,0,6,6,0.7467
90,neeraj.chauhan,6,0,0,6,6,0.8159
91,nilesh.bhuvad,3,0,0,3,3,0.8731
92,nilesh.warekar,1,0,0,1,1,0.7852
93,nithya.manoharan,1,0,0,1,1,0.815
94,p3-stores,1,0,0,1,1,0.8155
95,p5inprocessaudit,2,0,0,2,2,0.8004
96,p5receipt,2,0,0,2,2,0.8038
97,palanisamy.varatharaju,3,0,0,3,3,0.8484
98,pankajbisht,4,1,0,5,5,0.715
99,partheeban.mariaxavier,6,1,0,7,7,0.8119
100,pdb_scanner,1,2,0,3,3,0.8555
101,pde_peil,1,0,0,1,1,0.767
102,phelics.joseph,1,0,0,1,1,0.8535
103,plant1.itfms,19,0,0,19,19,
104,plant2.printing,2,0,0,2,2,
105,plant5.ppc,1,0,0,1,1,
106,prabhakaran.palanisami,3,0,0,3,3,0.7764
107,prakash.ponnusamy,1,0,0,1,1,0.7123
108,prasad.sivasamy,1,0,0,1,1,0.8202
109,praveenkumar.nataraj,0,1,0,1,1,0.7931
110,premkumar.karuppusamy,1,0,0,1,1,0.8426
111,premramesh.sk,1,0,0,1,1,0.8488
112,qe-giipumps,38,1,0,39,39,0.8107
113,ragul.kanapathy,1,0,0,1,1,0.7483
114,raja.andithevar,3,0,0,3,3,0.7933
115,raja.yelimbeti,1,1,0,2,2,0.8545
116,rajaganesan.siva,2,0,0,2,2,0.752
117,rajasekarp,1,2,0,3,3,0.7751
118,rajendrakumar.dalai,0,1,0,1,1,0.7894
119,rajkumar.arumugam,4,1,0,5,5,0.8063
120,rajneesh.pathak,1,0,0,1,1,0.7402
121,ramanathan.jayakumar,0,1,0,1,1,0.8596
122,ranjithkumar.nagaraj,0,1,0,1,1,0.8272
123,ravi.pappuswamy,1,0,0,1,1,0.7971
124,rekha.jayachandran,1,0,0,1,1,0.858
125,rubel.kristy,2,0,0,2,2,0.7538
126,sagar.chaudhari,2,0,0,2,2,0.8536
127,sagar.praburaj,1,0,0,1,1,0.8247
128,sajitha.rajendran,1,0,0,1,1,0.7677
129,sampat.gunjawate,4,1,0,5,5,0.8164
130,sanjay.nadkar,1,0,0,1,1,0.7937
131,sanmugavel.ramasamy,2,0,0,2,2,0.8674
132,santhanam.ponraj,0,2,0,2,2,0.7606
133,santhosh.venkatesan,5,0,0,5,5,0.8413
134,santhoshkumar.thiyagarajan,2,0,0,2,2,0.7837
135,saravanan.mohan,1,0,0,1,1,0.7786
136,sasivarathan.venkatapathy,3,1,0,4,4,0.8279
137,satheesh.palanisamy,1,0,0,1,1,0.7598
138,sathishkumar.balasundram,0,2,0,2,2,0.8088
139,sathyamoorthy.packirisamy,1,1,0,2,2,0.8173
140,sathyamurthy.nallathambi,0,1,0,1,1,0.7698
141,selvakumar.murugan,3,0,0,3,3,0.7815
142,selvakumar.sellamuthu,0,1,0,1,1,0.8017
143,senthilbd,1,1,0,2,2,0.7517
144,senthilkumar.shunmugasundaram,1,0,0,1,1,0.8444
145,senthilkumarbd,5,1,0,6,6,0.7223
146,senthilnathan.pachamuthu,2,2,0,4,4,0.8467
147,senthilrpde,1,1,0,2,2,0.7413
148,seshadri,2,1,0,3,3,0.8721
149,shaikh.alauddin,1,0,0,1,1,0.7618
150,sheikshabjan.janbasha,1,0,0,1,1,0.7783
151,sivasakthi.murugesan,1,0,0,1,1,0.8434
152,spiceworks,3,3,0,6,6,0.8496
153,srikanth.ramabadran,1,0,0,1,1,0.8707
154,sudarshan.sridhar,1,0,0,1,1,0.819
155,sudheer.menon,2,0,0,2,2,0.7624
156,sudheer.menon,2,0,0,2,2,0.8593
157,sugumaran.jayabalan,2,6,0,8,8,0.7477
158,sujit.wagh,1,0,0,1,1,0.7477
159,sumit.gangwar,1,0,0,1,1,0.8256
160,suresht,1,0,0,1,1,0.8025
161,syedibrahim.haneefa,1,0,0,1,1,0.7979
162,tejas.chavan,1,0,0,1,1,0.72
163,thangaraj.nataraj,2,1,0,3,3,0.8247
164,tvs_bd,1,0,0,1,1,0.7956
165,uma.aruchamy,1,0,0,1,1,0.746
166,vasantharaj.mani,1,0,0,1,1,0.734
167,vidhya.jegadeeswaran,1,0,0,1,1,0.7982
168,vignesh.raj,3,2,0,5,5,0.8549
169,vikram.singh,5,0,0,5,5,0.8617
170,vikram,1,0,0,1,1,0.8404
171,vinodyadav,1,1,0,2,2,0.8517
172,vishal.kumar,2,0,0,2,2,0.8076
173,yogeshchaughule,1,1,0,2,2,0.7932
174,yogeshchaughule,1,1,0,2,2,0.8145
175,yuvaraj.rajendran,2,0,0,2,2,0.8142
176,yuvarajan.paneerselvam,1,0,0,1,1,0.7848
